Id : 481  The Federal Reserve System's Weekly Balance Sheet Since 1914
CACP                                    Capital Accounts: Capital Paid in                                                                                                       NSA  Weekly, Ending Wednesday 10-Feb-2021  
CAOCARC                                 Capital Accounts: Other Capital Account Items: Reserve for Contingencies, Other Capital Accounts                                        NSA  Weekly, Ending Wednesday 10-Feb-2021  
CAOCASFDICS04151934                     Capital Accounts: Other Capital Account Items: Subscription for Federal Deposit Insurance Corporation Stock Called for Payment on Apri  NSA  Weekly, Ending Wednesday 10-Feb-2021  
CAOCASFDICSP                            Capital Accounts: Other Capital Account Items: Subscription for Federal Deposit Insurance Corporation Stock Paid                        NSA  Weekly, Ending Wednesday 10-Feb-2021  
CASS13B                                 Capital Accounts: Surplus: Section 13b                                                                                                  NSA  Weekly, Ending Wednesday 10-Feb-2021  
CASS7                                   Capital Accounts: Surplus: Section 7                                                                                                    NSA  Weekly, Ending Wednesday 10-Feb-2021  
CASSNS                                  Capital Accounts: Surplus: Surplus Not Specified                                                                                        NSA  Weekly, Ending Wednesday 10-Feb-2021  
CASTOTS                                 Capital Accounts: Surplus: Total Surplus                                                                                                NSA  Weekly, Ending Wednesday 10-Feb-2021  
CATOTCA                                 Capital Accounts: Total Capital Accounts                                                                                                NSA  Weekly, Ending Wednesday 10-Feb-2021  
HMRESPPMAIXNWW                          Memorandum Items: Items in Process of Collection, Eliminations from Consolidation                                                       NSA  Weekly, Ending Wednesday 10-Feb-2021  
HMRESPPMAXNWW                           Memorandum Items: Total Assets, Eliminations from Consolidation                                                                         NSA  Weekly, Ending Wednesday 10-Feb-2021  
HMRESPPMLLCXNWW                         Memorandum Items: Deferred Availability Cash Items, Eliminations from Consolidation                                                     NSA  Weekly, Ending Wednesday 10-Feb-2021  
HMRESPPMLLDOXNWW                        Memorandum Items: Deposits with Federal Reserve Banks: Other, Eliminations from Consolidation                                           NSA  Weekly, Ending Wednesday 10-Feb-2021  
HMRESPPMLLDXNWW                         Memorandum Items: Deposits, Eliminations from Consolidation: Wednesday level                                                            NSA  Weekly, As of Wednesday 10-Feb-2021  
HMRESPPMLLXNWW                          Memorandum Items: Total Liabilities, Eliminations from Consolidation                                                                    NSA  Weekly, Ending Wednesday 10-Feb-2021  
LDDFRB                                  Liabilities: Deposits: Deposits with Federal Reserve Banks, other than Reserve Balances                                                 NSA  Weekly, Ending Wednesday 10-Feb-2021  
LDDNMBSDNMB                             Liabilities: Deposits: Due to Nonmember Banks -- Clearing Account, Special Deposits of Nonmember Banks                                  NSA  Weekly, Ending Wednesday 10-Feb-2021  
LDFBFOA                                 Liabilities: Deposits: Foreign Bank, Foreign Official Accounts                                                                          NSA  Weekly, Ending Wednesday 10-Feb-2021  
LDGUST                                  Liabilities: Deposits: Government, U.S. Treasury -- General Account                                                                     NSA  Weekly, Ending Wednesday 10-Feb-2021  
LDMB                                    Liabilities: Deposits: Member Bank Reserve Account                                                                                      NSA  Weekly, Ending Wednesday 10-Feb-2021  
LDOD                                    Liabilities: Deposits: Other Deposits                                                                                                   NSA  Weekly, Ending Wednesday 10-Feb-2021  
LDODHDI                                 Liabilities: Deposits: Other Deposits Held by Depository Institutions                                                                   NSA  Weekly, Ending Wednesday 10-Feb-2021  
LDSDMB                                  Liabilities: Deposits: Special Deposits of Member Banks                                                                                 NSA  Weekly, Ending Wednesday 10-Feb-2021  
LDTDHDI                                 Liabilities: Deposits: Term Deposits Held by Depository Institutions                                                                    NSA  Weekly, Ending Wednesday 10-Feb-2021  
LDTOTD                                  Liabilities: Deposits: Total Deposits                                                                                                   NSA  Weekly, Ending Wednesday 10-Feb-2021  
LDUSTSA                                 Liabilities: Deposits: U.S. Treasury, Supplementary Financing Account                                                                   NSA  Weekly, Ending Wednesday 10-Feb-2021  
LNCFRBNC                                Liabilities: Notes in Circulation: Federal Reserve Bank Notes in Actual Circulation                                                     NSA  Weekly, Ending Wednesday 10-Feb-2021  
LNCFRNC                                 Liabilities: Notes in Circulation: Federal Reserve Notes in Actual Circulation                                                          NSA  Weekly, Ending Wednesday 10-Feb-2021  
LOLAOL                                  Liabilities: Other Liabilities: All Other Liabilities, Other Liabilities and Accrued Dividends                                          NSA  Weekly, Ending Wednesday 10-Feb-2021  
LOLDOFRB                                Liabilities: Other Liabilities: Due to Other Federal Reserve Banks, Collection Items, Deferred Availability Items                       NSA  Weekly, Ending Wednesday 10-Feb-2021  
LOLGFT                                  Liabilities: Other Liabilities: Government Franchise Tax                                                                                NSA  Weekly, Ending Wednesday 10-Feb-2021  
LOLRPA                                  Liabilities: Other Liabilities: Reverse Repurchase Agreements -- Triparty                                                               NSA  Weekly, Ending Wednesday 10-Feb-2021  
LTOTL                                   Liabilities: Total Liabilities                                                                                                          NSA  Weekly, Ending Wednesday 10-Feb-2021  
MBBOPMKAR                               Memorandum Items: Bills Bought on Open Market                                                                                           NSA  Weekly, Ending Wednesday 10-Feb-2021  
MCONLIAPFC                              Memorandum Items: Contingent Liability on Acceptances Purchased for Foreign Correspondents                                              NSA  Weekly, Ending Wednesday 10-Feb-2021  
MCONLIBPFC                              Memorandum Items: Contingent Liability on Bills Purchased for Foreign Correspondents                                                    NSA  Weekly, Ending Wednesday 10-Feb-2021  
MINLOCMILA                              Memorandum Items: Industrial Loan Commitments; Commitments to Make Industrial Advances                                                  NSA  Weekly, Ending Wednesday 10-Feb-2021  
MRAATAAR                                Memorandum Items: Bank Acceptances                                                                                                      NSA  Weekly, Ending Wednesday 10-Feb-2021  
MRAGGCTGGCLIB                           Memorandum Items: Ratio of Gold Certificate Reserves to Deposit and Federal Reserve Note Liabilities Combined                           NSA  Weekly, Ending Wednesday 10-Feb-2021  
RAAAAPABO                               Resources and Assets: Acceptances: Acceptances; Acceptances Purchased; Acceptances Bought Outright                                      NSA  Weekly, Ending Wednesday 10-Feb-2021  
RAAHURA                                 Resources and Assets: Acceptances: Held Under Repurchase Agreements                                                                     NSA  Weekly, Ending Wednesday 10-Feb-2021  
RAATA                                   Resources and Assets: Acceptances: Total Acceptances                                                                                    NSA  Weekly, Ending Wednesday 10-Feb-2021  
RABBOM                                  Resources and Assets: Bills Bought on Open Market                                                                                       NSA  Weekly, Ending Wednesday 10-Feb-2021  
RABDL10D                                Resources and Assets: Bills Discounted: Bills Discounted and Loans Within 10 Days                                                       NSA  Weekly, Ending Wednesday 10-Feb-2021  
RABDL30D                                Resources and Assets: Bills Discounted: Bills Discounted and Loans Within 30 Days                                                       NSA  Weekly, Ending Wednesday 10-Feb-2021  
RABDL60D                                Resources and Assets: Bills Discounted: Bills Discounted and Loans Within 60 Days                                                       NSA  Weekly, Ending Wednesday 10-Feb-2021  
RABDL90D                                Resources and Assets: Bills Discounted: Bills Discounted and Loans Within 90 Days                                                       NSA  Weekly, Ending Wednesday 10-Feb-2021  
RABDLNS                                 Resources and Assets: Bills Discounted: Bills Discounted and Loans Not Specified                                                        NSA  Weekly, Ending Wednesday 10-Feb-2021  
RABDLO90D                               Resources and Assets: Bills Discounted: Bills Discounted and Loans Over 90 Days                                                         NSA  Weekly, Ending Wednesday 10-Feb-2021  
RABDOB                                  Resources and Assets: Bills Discounted: Other Bills Discounted; Discounts and Advances                                                  NSA  Weekly, Ending Wednesday 10-Feb-2021  
RABDSGWOL                               Resources and Assets: Bills Discounted: Bills Secured by Government War Obligations; U.S. Government Obligations, Direct and Guarantee  NSA  Weekly, Ending Wednesday 10-Feb-2021  
RABDTBD                                 Resources and Assets: Bills Discounted: Total Bills Discounted                                                                          NSA  Weekly, Ending Wednesday 10-Feb-2021  
RABP                                    Resources and Assets: Bank Premises                                                                                                     NSA  Weekly, Ending Wednesday 10-Feb-2021  
RACBLS                                  Resources and Assets: Central Bank Liquidity Swaps                                                                                      NSA  Weekly, Ending Wednesday 10-Feb-2021  
RADDB                                   Resources and Assets: Due from Depository Banks -- Fiscal Agent Account                                                                 NSA  Weekly, Ending Wednesday 10-Feb-2021  
RADFFB                                  Resources and Assets: Due from Foreign Banks                                                                                            NSA  Weekly, Ending Wednesday 10-Feb-2021  
RADFOFRB                                Resources and Assets: Due from Other Federal Reserve Banks and Federal Reserve Notes of Other Banks                                     NSA  Weekly, Ending Wednesday 10-Feb-2021  
RADRCA                                  Resources and Assets: Special Drawing Rights Certificate Account                                                                        NSA  Weekly, Ending Wednesday 10-Feb-2021  
RAFAOBO                                 Resources and Assets: Federal Agency Obligations: Bought Outright                                                                       NSA  Weekly, Ending Wednesday 10-Feb-2021  
RAFAOHURA                               Resources and Assets: Federal Agency Obligations: Held Under Repurchase Agreements                                                      NSA  Weekly, Ending Wednesday 10-Feb-2021  
RAFAONS                                 Resources and Assets: Federal Agency Obligations: Not Specified                                                                         NSA  Weekly, Ending Wednesday 10-Feb-2021  
RAFAOTFAO                               Resources and Assets: Federal Agency Obligations: Total Federal Agency Obligations                                                      NSA  Weekly, Ending Wednesday 10-Feb-2021  
RAFCDA                                  Resources and Assets: Foreign Currency Denominated Assets                                                                               NSA  Weekly, Ending Wednesday 10-Feb-2021  
RAFDICS                                 Resources and Assets: Federal Deposit Insurance Corporation (FDIC) Stock                                                                NSA  Weekly, Ending Wednesday 10-Feb-2021  
RAFLG                                   Resources and Assets: Foreign Loans on Gold                                                                                             NSA  Weekly, Ending Wednesday 10-Feb-2021  
RAFRNNA                                 Resources and Assets: Federal Reserve Notes, Net Assets                                                                                 NSA  Weekly, Ending Wednesday 10-Feb-2021  
RAGGCGCA                                Resources and Assets: Gold and Gold Certificates: Gold Certificate Account                                                              NSA  Weekly, Ending Wednesday 10-Feb-2021  
RAGGCGCC                                Resources and Assets: Gold and Gold Certificates: Gold Coin and Certificates in Vault; Gold and Gold Certificates held by Federal Rese  NSA  Weekly, Ending Wednesday 10-Feb-2021  
RAGGCGFA                                Resources and Assets: Gold and Gold Certificates: Gold with Foreign Agencies                                                            NSA  Weekly, Ending Wednesday 10-Feb-2021  
RAGGCGFRA                               Resources and Assets: Gold and Gold Certificates: Gold with Federal Reserve Agents                                                      NSA  Weekly, Ending Wednesday 10-Feb-2021  
RAGGCGRF                                Resources and Assets: Gold and Gold Certificates: Gold Redemption Fund with U.S. Treasurer; Treasury                                    NSA  Weekly, Ending Wednesday 10-Feb-2021  
RAGGCGSF                                Resources and Assets: Gold and Gold Certificates: Gold Settlement Fund with Federal Reserve Board                                       NSA  Weekly, Ending Wednesday 10-Feb-2021  
RAGGCHEFRN                              Resources and Assets: Gold and Gold Certificates: Gold Held Exclusively Against Federal Reserve Notes                                   NSA  Weekly, Ending Wednesday 10-Feb-2021  
RAGGCTGFR                               Resources and Assets: Gold and Gold Certificates: Total Gold Held by Federal Reserve Banks                                              NSA  Weekly, Ending Wednesday 10-Feb-2021  
RAGGCTGGC                               Resources and Assets: Gold and Gold Certificates: Total Gold; Gold Certificate Reserve                                                  NSA  Weekly, Ending Wednesday 10-Feb-2021  
RAGSHURA                                Resources and Assets: U.S. Government Securities: Held Under Repurchase Agreement                                                       NSA  Weekly, Ending Wednesday 10-Feb-2021  
RAGSOCID                                Resources and Assets: U.S. Government Securities: Bought or Held Outright: U.S. Certificates of Indebtness, Certificates and Bills      NSA  Weekly, Ending Wednesday 10-Feb-2021  
RAGSONBI                                Resources and Assets: U.S. Government Securities: Bought or Held Outright: Notes and Bonds, Inflation-Indexed                           NSA  Weekly, Ending Wednesday 10-Feb-2021  
RAGSONBN                                Resources and Assets: U.S. Government Securities: Bought or Held Outright: Notes and Bonds, Nominal                                     NSA  Weekly, Ending Wednesday 10-Feb-2021  
RAGSOSTC                                Resources and Assets: U.S. Government Securities: Bought or Held Outright: Special Treasury                                             NSA  Weekly, Ending Wednesday 10-Feb-2021  
RAGSOTBO                                Resources and Assets: U.S. Government Securities: Bought or Held Outright: Total Bought Outright                                        NSA  Weekly, Ending Wednesday 10-Feb-2021  
RAGSOUSB                                Resources and Assets: U.S. Government Securities: Bought or Held Outright: U.S. Bills                                                   NSA  Weekly, Ending Wednesday 10-Feb-2021  
RAGSOUSCID1PA                           Resources and Assets: U.S. Government Securities: Bought or Held Outright: U.S. Certificates of Indebtness, One Year Pittman Act        NSA  Weekly, Ending Wednesday 10-Feb-2021  
RAGSOUSCIDO                             Resources and Assets: U.S. Government Securities: Bought or Held Outright: U.S. Certificates of Indebtness, All Other                   NSA  Weekly, Ending Wednesday 10-Feb-2021  
RAGSOUSTB                               Resources and Assets: U.S. Government Securities: Bought or Held Outright: U.S. Treasury Bonds                                          NSA  Weekly, Ending Wednesday 10-Feb-2021  
RAGSOUSTN                               Resources and Assets: U.S. Government Securities: Bought or Held Outright: U.S. Treasury Notes                                          NSA  Weekly, Ending Wednesday 10-Feb-2021  
RAGSOUSTSIC                             Resources and Assets: U.S. Government Securities: Bought or Held Outright: U.S. Treasury Securities: Inflation Compensation             NSA  Weekly, Ending Wednesday 10-Feb-2021  
RAGSOUSVN                               Resources and Assets: U.S. Government Securities: Bought or Held Outright: U.S. Victory Notes                                           NSA  Weekly, Ending Wednesday 10-Feb-2021  
RAGSTUSTS                               Resources and Assets: U.S. Government Securities: Total U.S. Treasury Securities                                                        NSA  Weekly, Ending Wednesday 10-Feb-2021  
RAGTCFFB                                Resources and Assets: Gold in Transit or in Custody from Foreign Banks and Gold Held Abroad                                             NSA  Weekly, Ending Wednesday 10-Feb-2021  
RAIAIL                                  Resources and Assets: Industrial Advances and Industrial Loans                                                                          NSA  Weekly, Ending Wednesday 10-Feb-2021  
RAIMWOEA                                Resources and Assets: Investments; Municipal Warrants; All Other Earning Assets                                                         NSA  Weekly, Ending Wednesday 10-Feb-2021  
RAIPGRNPCPFF                            Resources and Assets: Investment Portfolios Arising from the Great Recession: Net Portfolio Holdings of Commercial Paper Funding Facil  NSA  Weekly, Ending Wednesday 10-Feb-2021  
RAIPGRNPML1                             Resources and Assets: Investment Portfolios Arising from the Great Recession: Net Portfolio Holdings of Maiden Laine I LLC              NSA  Weekly, Ending Wednesday 10-Feb-2021  
RAIPGRNPML2                             Resources and Assets: Investment Portfolios Arising from the Great Recession: Net Portfolio Holdings of Maiden Laine II LLC             NSA  Weekly, Ending Wednesday 10-Feb-2021  
RAIPGRNPML3                             Resources and Assets: Investment Portfolios Arising from the Great Recession: Net Portfolio Holdings of Maiden Laine III LLC            NSA  Weekly, Ending Wednesday 10-Feb-2021  
RAIPGRNPTALF                            Resources and Assets: Investment Portfolios Arising from the Great Recession: Net Portfolio Holdings of TALF LLC                        NSA  Weekly, Ending Wednesday 10-Feb-2021  
RAIPGRPH                                Resources and Assets: Investment Portfolios Arising from the Great Recession: Preferred Holdings in AIA Aurora LLC and ALICO Holdings   NSA  Weekly, Ending Wednesday 10-Feb-2021  
RALGCB                                  Resources and Assets: Loans on Gold Coin and Bullion                                                                                    NSA  Weekly, Ending Wednesday 10-Feb-2021  
RALTSCCRO                               Resources and Assets: Legal Tender Notes, Silver Certificates, and Subsidiary Coin; Reserves Other than Gold; Other Cash                NSA  Weekly, Ending Wednesday 10-Feb-2021  
RAMBS                                   Resources and Assets: Mortgage-Backed Securities                                                                                        NSA  Weekly, Ending Wednesday 10-Feb-2021  
RANRC                                   Resources and Assets: Nonreserve Cash                                                                                                   NSA  Weekly, Ending Wednesday 10-Feb-2021  
RAOE                                    Resources and Assets: Operating Equipment                                                                                               NSA  Weekly, Ending Wednesday 10-Feb-2021  
RAOR                                    Resources and Assets: All Other Resources or Assets                                                                                     NSA  Weekly, Ending Wednesday 10-Feb-2021  
RAOS                                    Resources and Assets: Other Securities                                                                                                  NSA  Weekly, Ending Wednesday 10-Feb-2021  
RARFFRBN                                Resources and Assets: Redemption Fund of 5% for Federal Reserve Bank Notes                                                              NSA  Weekly, Ending Wednesday 10-Feb-2021  
RATAC                                   Resources and Assets: Term Auction Credit                                                                                               NSA  Weekly, Ending Wednesday 10-Feb-2021  
RATBOH                                  Resources and Assets: Total Bills on Hand                                                                                               NSA  Weekly, Ending Wednesday 10-Feb-2021  
RATDGD                                  Resources and Assets: Total Deductions form Gross Deposits                                                                              NSA  Weekly, Ending Wednesday 10-Feb-2021  
RATEATIESTBS                            Resources and Assets: Total Earning Assets, Total Interest Securities, Total Bills; Loans and Securities                                NSA  Weekly, Ending Wednesday 10-Feb-2021  
RATPRA                                  Resources and Assets: Tri-Party Repo Agreements, Repurchase Agreements                                                                  NSA  Weekly, Ending Wednesday 10-Feb-2021  
RATR                                    Resources and Assets: Total Reserves                                                                                                    NSA  Weekly, Ending Wednesday 10-Feb-2021  
RATSHO                                  Resources and Assets: Total Securities Held Outright                                                                                    NSA  Weekly, Ending Wednesday 10-Feb-2021  
RAUDSHO                                 Resources and Assets: Unamortized Discounts on Securities Held Outright                                                                 NSA  Weekly, Ending Wednesday 10-Feb-2021  
RAUICIP                                 Resources and Assets: Uncollected Items and Cash Items in Process of Collection                                                         NSA  Weekly, Ending Wednesday 10-Feb-2021  
RAUPSHO                                 Resources and Assets: Unamortized Premiums on Securities Held Outright                                                                  NSA  Weekly, Ending Wednesday 10-Feb-2021  
TOTLCA                                  Total Liabilities and Capital Accounts                                                                                                  NSA  Weekly, Ending Wednesday 10-Feb-2021  
TOTRA                                   Resources and Assets: Total Resources and Assets                                                                                        NSA  Weekly, Ending Wednesday 10-Feb-2021  
