Id : 449  U.S. Trade in Goods by State, by NAICS-Based Product
EXPMANAK                                Exports of Goods: Manufactured Commodities for Alaska                                                                                   NSA  Monthly    06-Dec-2022  
EXPMANAL                                Exports of Goods: Manufactured Commodities for Alabama                                                                                  NSA  Monthly    06-Dec-2022  
EXPMANAR                                Exports of Goods: Manufactured Commodities for Arkansas                                                                                 NSA  Monthly    06-Dec-2022  
EXPMANAZ                                Exports of Goods: Manufactured Commodities for Arizona                                                                                  NSA  Monthly    06-Dec-2022  
EXPMANCA                                Exports of Goods: Manufactured Commodities for California                                                                               NSA  Monthly    06-Dec-2022  
EXPMANCO                                Exports of Goods: Manufactured Commodities for Colorado                                                                                 NSA  Monthly    06-Dec-2022  
EXPMANCT                                Exports of Goods: Manufactured Commodities for Connecticut                                                                              NSA  Monthly    06-Dec-2022  
EXPMANDC                                Exports of Goods: Manufactured Commodities for District of Columbia                                                                     NSA  Monthly    06-Dec-2022  
EXPMANDE                                Exports of Goods: Manufactured Commodities for Delaware                                                                                 NSA  Monthly    06-Dec-2022  
EXPMANFL                                Exports of Goods: Manufactured Commodities for Florida                                                                                  NSA  Monthly    06-Dec-2022  
EXPMANGA                                Exports of Goods: Manufactured Commodities for Georgia                                                                                  NSA  Monthly    06-Dec-2022  
EXPMANHI                                Exports of Goods: Manufactured Commodities for Hawaii                                                                                   NSA  Monthly    06-Dec-2022  
EXPMANIA                                Exports of Goods: Manufactured Commodities for Iowa                                                                                     NSA  Monthly    06-Dec-2022  
EXPMANID                                Exports of Goods: Manufactured Commodities for Idaho                                                                                    NSA  Monthly    06-Dec-2022  
EXPMANIL                                Exports of Goods: Manufactured Commodities for Illinois                                                                                 NSA  Monthly    06-Dec-2022  
EXPMANIN                                Exports of Goods: Manufactured Commodities for Indiana                                                                                  NSA  Monthly    06-Dec-2022  
EXPMANKS                                Exports of Goods: Manufactured Commodities for Kansas                                                                                   NSA  Monthly    06-Dec-2022  
EXPMANKY                                Exports of Goods: Manufactured Commodities for Kentucky                                                                                 NSA  Monthly    06-Dec-2022  
EXPMANLA                                Exports of Goods: Manufactured Commodities for Louisiana                                                                                NSA  Monthly    06-Dec-2022  
EXPMANMA                                Exports of Goods: Manufactured Commodities for Massachusetts                                                                            NSA  Monthly    06-Dec-2022  
EXPMANMD                                Exports of Goods: Manufactured Commodities for Maryland                                                                                 NSA  Monthly    06-Dec-2022  
EXPMANME                                Exports of Goods: Manufactured Commodities for Maine                                                                                    NSA  Monthly    06-Dec-2022  
EXPMANMI                                Exports of Goods: Manufactured Commodities for Michigan                                                                                 NSA  Monthly    06-Dec-2022  
EXPMANMN                                Exports of Goods: Manufactured Commodities for Minnesota                                                                                NSA  Monthly    06-Dec-2022  
EXPMANMO                                Exports of Goods: Manufactured Commodities for Missouri                                                                                 NSA  Monthly    06-Dec-2022  
EXPMANMS                                Exports of Goods: Manufactured Commodities for Mississippi                                                                              NSA  Monthly    06-Dec-2022  
EXPMANMT                                Exports of Goods: Manufactured Commodities for Montana                                                                                  NSA  Monthly    06-Dec-2022  
EXPMANNC                                Exports of Goods: Manufactured Commodities for North Carolina                                                                           NSA  Monthly    06-Dec-2022  
EXPMANND                                Exports of Goods: Manufactured Commodities for North Dakota                                                                             NSA  Monthly    06-Dec-2022  
EXPMANNE                                Exports of Goods: Manufactured Commodities for Nebraska                                                                                 NSA  Monthly    06-Dec-2022  
EXPMANNH                                Exports of Goods: Manufactured Commodities for New Hampshire                                                                            NSA  Monthly    06-Dec-2022  
EXPMANNJ                                Exports of Goods: Manufactured Commodities for New Jersey                                                                               NSA  Monthly    06-Dec-2022  
EXPMANNM                                Exports of Goods: Manufactured Commodities for New Mexico                                                                               NSA  Monthly    06-Dec-2022  
EXPMANNV                                Exports of Goods: Manufactured Commodities for Nevada                                                                                   NSA  Monthly    06-Dec-2022  
EXPMANNY                                Exports of Goods: Manufactured Commodities for New York                                                                                 NSA  Monthly    06-Dec-2022  
EXPMANOH                                Exports of Goods: Manufactured Commodities for Ohio                                                                                     NSA  Monthly    06-Dec-2022  
EXPMANOK                                Exports of Goods: Manufactured Commodities for Oklahoma                                                                                 NSA  Monthly    06-Dec-2022  
EXPMANOR                                Exports of Goods: Manufactured Commodities for Oregon                                                                                   NSA  Monthly    06-Dec-2022  
EXPMANPA                                Exports of Goods: Manufactured Commodities for Pennsylvania                                                                             NSA  Monthly    06-Dec-2022  
EXPMANPR                                Exports of Goods: Manufactured Commodities for Puerto Rico                                                                              NSA  Monthly    06-Dec-2022  
EXPMANRI                                Exports of Goods: Manufactured Commodities for Rhode Island                                                                             NSA  Monthly    06-Dec-2022  
EXPMANSC                                Exports of Goods: Manufactured Commodities for South Carolina                                                                           NSA  Monthly    06-Dec-2022  
EXPMANSD                                Exports of Goods: Manufactured Commodities for South Dakota                                                                             NSA  Monthly    06-Dec-2022  
EXPMANTN                                Exports of Goods: Manufactured Commodities for Tennessee                                                                                NSA  Monthly    06-Dec-2022  
EXPMANTX                                Exports of Goods: Manufactured Commodities for Texas                                                                                    NSA  Monthly    06-Dec-2022  
EXPMANUS                                Exports of Goods: Manufactured Commodities for United States                                                                            NSA  Monthly    06-Dec-2022  
EXPMANUT                                Exports of Goods: Manufactured Commodities for Utah                                                                                     NSA  Monthly    06-Dec-2022  
EXPMANVA                                Exports of Goods: Manufactured Commodities for Virginia                                                                                 NSA  Monthly    06-Dec-2022  
EXPMANVI                                Exports of Goods: Manufactured Commodities for U.S. Virgin Islands                                                                      NSA  Monthly    06-Dec-2022  
EXPMANVT                                Exports of Goods: Manufactured Commodities for Vermont                                                                                  NSA  Monthly    06-Dec-2022  
EXPMANWA                                Exports of Goods: Manufactured Commodities for Washington                                                                               NSA  Monthly    06-Dec-2022  
EXPMANWI                                Exports of Goods: Manufactured Commodities for Wisconsin                                                                                NSA  Monthly    06-Dec-2022  
EXPMANWV                                Exports of Goods: Manufactured Commodities for West Virginia                                                                            NSA  Monthly    06-Dec-2022  
EXPMANWY                                Exports of Goods: Manufactured Commodities for Wyoming                                                                                  NSA  Monthly    06-Dec-2022  
EXPNONAK                                Exports of Goods: Non-Manufactured Commodities for Alaska                                                                               NSA  Monthly    06-Dec-2022  
EXPNONAL                                Exports of Goods: Non-Manufactured Commodities for Alabama                                                                              NSA  Monthly    06-Dec-2022  
EXPNONAR                                Exports of Goods: Non-Manufactured Commodities for Arkansas                                                                             NSA  Monthly    06-Dec-2022  
EXPNONAZ                                Exports of Goods: Non-Manufactured Commodities for Arizona                                                                              NSA  Monthly    06-Dec-2022  
EXPNONCA                                Exports of Goods: Non-Manufactured Commodities for California                                                                           NSA  Monthly    06-Dec-2022  
EXPNONCO                                Exports of Goods: Non-Manufactured Commodities for Colorado                                                                             NSA  Monthly    06-Dec-2022  
EXPNONCT                                Exports of Goods: Non-Manufactured Commodities for Connecticut                                                                          NSA  Monthly    06-Dec-2022  
EXPNONDC                                Exports of Goods: Non-Manufactured Commodities for District of Columbia                                                                 NSA  Monthly    06-Dec-2022  
EXPNONDE                                Exports of Goods: Non-Manufactured Commodities for Delaware                                                                             NSA  Monthly    06-Dec-2022  
EXPNONFL                                Exports of Goods: Non-Manufactured Commodities for Florida                                                                              NSA  Monthly    06-Dec-2022  
EXPNONGA                                Exports of Goods: Non-Manufactured Commodities for Georgia                                                                              NSA  Monthly    06-Dec-2022  
EXPNONHI                                Exports of Goods: Non-Manufactured Commodities for Hawaii                                                                               NSA  Monthly    06-Dec-2022  
EXPNONIA                                Exports of Goods: Non-Manufactured Commodities for Iowa                                                                                 NSA  Monthly    06-Dec-2022  
EXPNONID                                Exports of Goods: Non-Manufactured Commodities for Idaho                                                                                NSA  Monthly    06-Dec-2022  
EXPNONIL                                Exports of Goods: Non-Manufactured Commodities for Illinois                                                                             NSA  Monthly    06-Dec-2022  
EXPNONIN                                Exports of Goods: Non-Manufactured Commodities for Indiana                                                                              NSA  Monthly    06-Dec-2022  
EXPNONKS                                Exports of Goods: Non-Manufactured Commodities for Kansas                                                                               NSA  Monthly    06-Dec-2022  
EXPNONKY                                Exports of Goods: Non-Manufactured Commodities for Kentucky                                                                             NSA  Monthly    06-Dec-2022  
EXPNONLA                                Exports of Goods: Non-Manufactured Commodities for Louisiana                                                                            NSA  Monthly    06-Dec-2022  
EXPNONMA                                Exports of Goods: Non-Manufactured Commodities for Massachusetts                                                                        NSA  Monthly    06-Dec-2022  
EXPNONMD                                Exports of Goods: Non-Manufactured Commodities for Maryland                                                                             NSA  Monthly    06-Dec-2022  
EXPNONME                                Exports of Goods: Non-Manufactured Commodities for Maine                                                                                NSA  Monthly    06-Dec-2022  
EXPNONMI                                Exports of Goods: Non-Manufactured Commodities for Michigan                                                                             NSA  Monthly    06-Dec-2022  
EXPNONMN                                Exports of Goods: Non-Manufactured Commodities for Minnesota                                                                            NSA  Monthly    06-Dec-2022  
EXPNONMO                                Exports of Goods: Non-Manufactured Commodities for Missouri                                                                             NSA  Monthly    06-Dec-2022  
EXPNONMS                                Exports of Goods: Non-Manufactured Commodities for Mississippi                                                                          NSA  Monthly    06-Dec-2022  
EXPNONMT                                Exports of Goods: Non-Manufactured Commodities for Montana                                                                              NSA  Monthly    06-Dec-2022  
EXPNONNC                                Exports of Goods: Non-Manufactured Commodities for North Carolina                                                                       NSA  Monthly    06-Dec-2022  
EXPNONND                                Exports of Goods: Non-Manufactured Commodities for North Dakota                                                                         NSA  Monthly    06-Dec-2022  
EXPNONNE                                Exports of Goods: Non-Manufactured Commodities for Nebraska                                                                             NSA  Monthly    06-Dec-2022  
EXPNONNH                                Exports of Goods: Non-Manufactured Commodities for New Hampshire                                                                        NSA  Monthly    06-Dec-2022  
EXPNONNJ                                Exports of Goods: Non-Manufactured Commodities for New Jersey                                                                           NSA  Monthly    06-Dec-2022  
EXPNONNM                                Exports of Goods: Non-Manufactured Commodities for New Mexico                                                                           NSA  Monthly    06-Dec-2022  
EXPNONNV                                Exports of Goods: Non-Manufactured Commodities for Nevada                                                                               NSA  Monthly    06-Dec-2022  
EXPNONNY                                Exports of Goods: Non-Manufactured Commodities for New York                                                                             NSA  Monthly    06-Dec-2022  
EXPNONOH                                Exports of Goods: Non-Manufactured Commodities for Ohio                                                                                 NSA  Monthly    06-Dec-2022  
EXPNONOK                                Exports of Goods: Non-Manufactured Commodities for Oklahoma                                                                             NSA  Monthly    06-Dec-2022  
EXPNONOR                                Exports of Goods: Non-Manufactured Commodities for Oregon                                                                               NSA  Monthly    06-Dec-2022  
EXPNONPA                                Exports of Goods: Non-Manufactured Commodities for Pennsylvania                                                                         NSA  Monthly    06-Dec-2022  
EXPNONPR                                Exports of Goods: Non-Manufactured Commodities for Puerto Rico                                                                          NSA  Monthly    06-Dec-2022  
EXPNONRI                                Exports of Goods: Non-Manufactured Commodities for Rhode Island                                                                         NSA  Monthly    06-Dec-2022  
EXPNONSC                                Exports of Goods: Non-Manufactured Commodities for South Carolina                                                                       NSA  Monthly    06-Dec-2022  
EXPNONSD                                Exports of Goods: Non-Manufactured Commodities for South Dakota                                                                         NSA  Monthly    06-Dec-2022  
EXPNONTN                                Exports of Goods: Non-Manufactured Commodities for Tennessee                                                                            NSA  Monthly    06-Dec-2022  
EXPNONTX                                Exports of Goods: Non-Manufactured Commodities for Texas                                                                                NSA  Monthly    06-Dec-2022  
EXPNONUS                                Exports of Goods: Non-Manufactured Commodities for United States                                                                        NSA  Monthly    06-Dec-2022  
EXPNONUT                                Exports of Goods: Non-Manufactured Commodities for Utah                                                                                 NSA  Monthly    06-Dec-2022  
EXPNONVA                                Exports of Goods: Non-Manufactured Commodities for Virginia                                                                             NSA  Monthly    06-Dec-2022  
EXPNONVI                                Exports of Goods: Non-Manufactured Commodities for U.S. Virgin Islands                                                                  NSA  Monthly    06-Dec-2022  
EXPNONVT                                Exports of Goods: Non-Manufactured Commodities for Vermont                                                                              NSA  Monthly    06-Dec-2022  
EXPNONWA                                Exports of Goods: Non-Manufactured Commodities for Washington                                                                           NSA  Monthly    06-Dec-2022  
EXPNONWI                                Exports of Goods: Non-Manufactured Commodities for Wisconsin                                                                            NSA  Monthly    06-Dec-2022  
EXPNONWV                                Exports of Goods: Non-Manufactured Commodities for West Virginia                                                                        NSA  Monthly    06-Dec-2022  
EXPNONWY                                Exports of Goods: Non-Manufactured Commodities for Wyoming                                                                              NSA  Monthly    06-Dec-2022  
EXPTOTAK                                Exports of Goods for Alaska                                                                                                             NSA  Monthly    06-Dec-2022  
EXPTOTAL                                Exports of Goods for Alabama                                                                                                            NSA  Monthly    06-Dec-2022  
EXPTOTAR                                Exports of Goods for Arkansas                                                                                                           NSA  Monthly    06-Dec-2022  
EXPTOTAZ                                Exports of Goods for Arizona                                                                                                            NSA  Monthly    06-Dec-2022  
EXPTOTCA                                Exports of Goods for California                                                                                                         NSA  Monthly    06-Dec-2022  
EXPTOTCO                                Exports of Goods for Colorado                                                                                                           NSA  Monthly    06-Dec-2022  
EXPTOTCT                                Exports of Goods for Connecticut                                                                                                        NSA  Monthly    06-Dec-2022  
EXPTOTDC                                Exports of Goods for District of Columbia                                                                                               NSA  Monthly    06-Dec-2022  
EXPTOTDE                                Exports of Goods for Delaware                                                                                                           NSA  Monthly    06-Dec-2022  
EXPTOTFL                                Exports of Goods for Florida                                                                                                            NSA  Monthly    06-Dec-2022  
EXPTOTGA                                Exports of Goods for Georgia                                                                                                            NSA  Monthly    06-Dec-2022  
EXPTOTHI                                Exports of Goods for Hawaii                                                                                                             NSA  Monthly    06-Dec-2022  
EXPTOTIA                                Exports of Goods for Iowa                                                                                                               NSA  Monthly    06-Dec-2022  
EXPTOTID                                Exports of Goods for Idaho                                                                                                              NSA  Monthly    06-Dec-2022  
EXPTOTIL                                Exports of Goods for Illinois                                                                                                           NSA  Monthly    06-Dec-2022  
EXPTOTIN                                Exports of Goods for Indiana                                                                                                            NSA  Monthly    06-Dec-2022  
EXPTOTKS                                Exports of Goods for Kansas                                                                                                             NSA  Monthly    06-Dec-2022  
EXPTOTKY                                Exports of Goods for Kentucky                                                                                                           NSA  Monthly    06-Dec-2022  
EXPTOTLA                                Exports of Goods for Louisiana                                                                                                          NSA  Monthly    06-Dec-2022  
EXPTOTMA                                Exports of Goods for Massachusetts                                                                                                      NSA  Monthly    06-Dec-2022  
EXPTOTMD                                Exports of Goods for Maryland                                                                                                           NSA  Monthly    06-Dec-2022  
EXPTOTME                                Exports of Goods for Maine                                                                                                              NSA  Monthly    06-Dec-2022  
EXPTOTMI                                Exports of Goods for Michigan                                                                                                           NSA  Monthly    06-Dec-2022  
EXPTOTMN                                Exports of Goods for Minnesota                                                                                                          NSA  Monthly    06-Dec-2022  
EXPTOTMO                                Exports of Goods for Missouri                                                                                                           NSA  Monthly    06-Dec-2022  
EXPTOTMS                                Exports of Goods for Mississippi                                                                                                        NSA  Monthly    06-Dec-2022  
EXPTOTMT                                Exports of Goods for Montana                                                                                                            NSA  Monthly    06-Dec-2022  
EXPTOTNC                                Exports of Goods for North Carolina                                                                                                     NSA  Monthly    06-Dec-2022  
EXPTOTND                                Exports of Goods for North Dakota                                                                                                       NSA  Monthly    06-Dec-2022  
EXPTOTNE                                Exports of Goods for Nebraska                                                                                                           NSA  Monthly    06-Dec-2022  
EXPTOTNH                                Exports of Goods for New Hampshire                                                                                                      NSA  Monthly    06-Dec-2022  
EXPTOTNJ                                Exports of Goods for New Jersey                                                                                                         NSA  Monthly    06-Dec-2022  
EXPTOTNM                                Exports of Goods for New Mexico                                                                                                         NSA  Monthly    06-Dec-2022  
EXPTOTNV                                Exports of Goods for Nevada                                                                                                             NSA  Monthly    06-Dec-2022  
EXPTOTNY                                Exports of Goods for New York                                                                                                           NSA  Monthly    06-Dec-2022  
EXPTOTOH                                Exports of Goods for Ohio                                                                                                               NSA  Monthly    06-Dec-2022  
EXPTOTOK                                Exports of Goods for Oklahoma                                                                                                           NSA  Monthly    06-Dec-2022  
EXPTOTOR                                Exports of Goods for Oregon                                                                                                             NSA  Monthly    06-Dec-2022  
EXPTOTPA                                Exports of Goods for Pennsylvania                                                                                                       NSA  Monthly    06-Dec-2022  
EXPTOTPR                                Exports of Goods for Puerto Rico                                                                                                        NSA  Monthly    06-Dec-2022  
EXPTOTRI                                Exports of Goods for Rhode Island                                                                                                       NSA  Monthly    06-Dec-2022  
EXPTOTSC                                Exports of Goods for South Carolina                                                                                                     NSA  Monthly    06-Dec-2022  
EXPTOTSD                                Exports of Goods for South Dakota                                                                                                       NSA  Monthly    06-Dec-2022  
EXPTOTTN                                Exports of Goods for Tennessee                                                                                                          NSA  Monthly    06-Dec-2022  
EXPTOTTX                                Exports of Goods for Texas                                                                                                              NSA  Monthly    06-Dec-2022  
EXPTOTUS                                Exports of Goods for United States                                                                                                      NSA  Monthly    06-Dec-2022  
EXPTOTUT                                Exports of Goods for Utah                                                                                                               NSA  Monthly    06-Dec-2022  
EXPTOTVA                                Exports of Goods for Virginia                                                                                                           NSA  Monthly    06-Dec-2022  
EXPTOTVI                                Exports of Goods for U.S. Virgin Islands                                                                                                NSA  Monthly    06-Dec-2022  
EXPTOTVT                                Exports of Goods for Vermont                                                                                                            NSA  Monthly    06-Dec-2022  
EXPTOTWA                                Exports of Goods for Washington                                                                                                         NSA  Monthly    06-Dec-2022  
EXPTOTWI                                Exports of Goods for Wisconsin                                                                                                          NSA  Monthly    06-Dec-2022  
EXPTOTWV                                Exports of Goods for West Virginia                                                                                                      NSA  Monthly    06-Dec-2022  
EXPTOTWY                                Exports of Goods for Wyoming                                                                                                            NSA  Monthly    06-Dec-2022  
IMPMANAK                                Imports of Goods: Manufactured Commodities for Alaska                                                                                   NSA  Monthly    06-Dec-2022  
IMPMANAL                                Imports of Goods: Manufactured Commodities for Alabama                                                                                  NSA  Monthly    06-Dec-2022  
IMPMANAR                                Imports of Goods: Manufactured Commodities for Arkansas                                                                                 NSA  Monthly    06-Dec-2022  
IMPMANAZ                                Imports of Goods: Manufactured Commodities for Arizona                                                                                  NSA  Monthly    06-Dec-2022  
IMPMANCA                                Imports of Goods: Manufactured Commodities for California                                                                               NSA  Monthly    06-Dec-2022  
IMPMANCO                                Imports of Goods: Manufactured Commodities for Colorado                                                                                 NSA  Monthly    06-Dec-2022  
IMPMANCT                                Imports of Goods: Manufactured Commodities for Connecticut                                                                              NSA  Monthly    06-Dec-2022  
IMPMANDC                                Imports of Goods: Manufactured Commodities for District of Columbia                                                                     NSA  Monthly    06-Dec-2022  
IMPMANDE                                Imports of Goods: Manufactured Commodities for Delaware                                                                                 NSA  Monthly    06-Dec-2022  
IMPMANFL                                Imports of Goods: Manufactured Commodities for Florida                                                                                  NSA  Monthly    06-Dec-2022  
IMPMANGA                                Imports of Goods: Manufactured Commodities for Georgia                                                                                  NSA  Monthly    06-Dec-2022  
IMPMANHI                                Imports of Goods: Manufactured Commodities for Hawaii                                                                                   NSA  Monthly    06-Dec-2022  
IMPMANIA                                Imports of Goods: Manufactured Commodities for Iowa                                                                                     NSA  Monthly    06-Dec-2022  
IMPMANID                                Imports of Goods: Manufactured Commodities for Idaho                                                                                    NSA  Monthly    06-Dec-2022  
IMPMANIL                                Imports of Goods: Manufactured Commodities for Illinois                                                                                 NSA  Monthly    06-Dec-2022  
IMPMANIN                                Imports of Goods: Manufactured Commodities for Indiana                                                                                  NSA  Monthly    06-Dec-2022  
IMPMANKS                                Imports of Goods: Manufactured Commodities for Kansas                                                                                   NSA  Monthly    06-Dec-2022  
IMPMANKY                                Imports of Goods: Manufactured Commodities for Kentucky                                                                                 NSA  Monthly    06-Dec-2022  
IMPMANLA                                Imports of Goods: Manufactured Commodities for Louisiana                                                                                NSA  Monthly    06-Dec-2022  
IMPMANMA                                Imports of Goods: Manufactured Commodities for Massachusetts                                                                            NSA  Monthly    06-Dec-2022  
IMPMANMD                                Imports of Goods: Manufactured Commodities for Maryland                                                                                 NSA  Monthly    06-Dec-2022  
IMPMANME                                Imports of Goods: Manufactured Commodities for Maine                                                                                    NSA  Monthly    06-Dec-2022  
IMPMANMI                                Imports of Goods: Manufactured Commodities for Michigan                                                                                 NSA  Monthly    06-Dec-2022  
IMPMANMN                                Imports of Goods: Manufactured Commodities for Minnesota                                                                                NSA  Monthly    06-Dec-2022  
IMPMANMO                                Imports of Goods: Manufactured Commodities for Missouri                                                                                 NSA  Monthly    06-Dec-2022  
IMPMANMS                                Imports of Goods: Manufactured Commodities for Mississippi                                                                              NSA  Monthly    06-Dec-2022  
IMPMANMT                                Imports of Goods: Manufactured Commodities for Montana                                                                                  NSA  Monthly    06-Dec-2022  
IMPMANNC                                Imports of Goods: Manufactured Commodities for North Carolina                                                                           NSA  Monthly    06-Dec-2022  
IMPMANND                                Imports of Goods: Manufactured Commodities for North Dakota                                                                             NSA  Monthly    06-Dec-2022  
IMPMANNE                                Imports of Goods: Manufactured Commodities for Nebraska                                                                                 NSA  Monthly    06-Dec-2022  
IMPMANNH                                Imports of Goods: Manufactured Commodities for New Hampshire                                                                            NSA  Monthly    06-Dec-2022  
IMPMANNJ                                Imports of Goods: Manufactured Commodities for New Jersey                                                                               NSA  Monthly    06-Dec-2022  
IMPMANNM                                Imports of Goods: Manufactured Commodities for New Mexico                                                                               NSA  Monthly    06-Dec-2022  
IMPMANNV                                Imports of Goods: Manufactured Commodities for Nevada                                                                                   NSA  Monthly    06-Dec-2022  
IMPMANNY                                Imports of Goods: Manufactured Commodities for New York                                                                                 NSA  Monthly    06-Dec-2022  
IMPMANOH                                Imports of Goods: Manufactured Commodities for Ohio                                                                                     NSA  Monthly    06-Dec-2022  
IMPMANOK                                Imports of Goods: Manufactured Commodities for Oklahoma                                                                                 NSA  Monthly    06-Dec-2022  
IMPMANOR                                Imports of Goods: Manufactured Commodities for Oregon                                                                                   NSA  Monthly    06-Dec-2022  
IMPMANPA                                Imports of Goods: Manufactured Commodities for Pennsylvania                                                                             NSA  Monthly    06-Dec-2022  
IMPMANPR                                Imports of Goods: Manufactured Commodities for Puerto Rico                                                                              NSA  Monthly    06-Dec-2022  
IMPMANRI                                Imports of Goods: Manufactured Commodities for Rhode Island                                                                             NSA  Monthly    06-Dec-2022  
IMPMANSC                                Imports of Goods: Manufactured Commodities for South Carolina                                                                           NSA  Monthly    06-Dec-2022  
IMPMANSD                                Imports of Goods: Manufactured Commodities for South Dakota                                                                             NSA  Monthly    06-Dec-2022  
IMPMANTN                                Imports of Goods: Manufactured Commodities for Tennessee                                                                                NSA  Monthly    06-Dec-2022  
IMPMANTX                                Imports of Goods: Manufactured Commodities for Texas                                                                                    NSA  Monthly    06-Dec-2022  
IMPMANUS                                Imports of Goods: Manufactured Commodities for United States                                                                            NSA  Monthly    06-Dec-2022  
IMPMANUT                                Imports of Goods: Manufactured Commodities for Utah                                                                                     NSA  Monthly    06-Dec-2022  
IMPMANVA                                Imports of Goods: Manufactured Commodities for Virginia                                                                                 NSA  Monthly    06-Dec-2022  
IMPMANVI                                Imports of Goods: Manufactured Commodities for U.S. Virgin Islands                                                                      NSA  Monthly    06-Dec-2022  
IMPMANVT                                Imports of Goods: Manufactured Commodities for Vermont                                                                                  NSA  Monthly    06-Dec-2022  
IMPMANWA                                Imports of Goods: Manufactured Commodities for Washington                                                                               NSA  Monthly    06-Dec-2022  
IMPMANWI                                Imports of Goods: Manufactured Commodities for Wisconsin                                                                                NSA  Monthly    06-Dec-2022  
IMPMANWV                                Imports of Goods: Manufactured Commodities for West Virginia                                                                            NSA  Monthly    06-Dec-2022  
IMPMANWY                                Imports of Goods: Manufactured Commodities for Wyoming                                                                                  NSA  Monthly    06-Dec-2022  
IMPNONAK                                Imports of Goods: Non-Manufactured Commodities for Alaska                                                                               NSA  Monthly    06-Dec-2022  
IMPNONAL                                Imports of Goods: Non-Manufactured Commodities for Alabama                                                                              NSA  Monthly    06-Dec-2022  
IMPNONAR                                Imports of Goods: Non-Manufactured Commodities for Arkansas                                                                             NSA  Monthly    06-Dec-2022  
IMPNONAZ                                Imports of Goods: Non-Manufactured Commodities for Arizona                                                                              NSA  Monthly    06-Dec-2022  
IMPNONCA                                Imports of Goods: Non-Manufactured Commodities for California                                                                           NSA  Monthly    06-Dec-2022  
IMPNONCO                                Imports of Goods: Non-Manufactured Commodities for Colorado                                                                             NSA  Monthly    06-Dec-2022  
IMPNONCT                                Imports of Goods: Non-Manufactured Commodities for Connecticut                                                                          NSA  Monthly    06-Dec-2022  
IMPNONDC                                Imports of Goods: Non-Manufactured Commodities for District of Columbia                                                                 NSA  Monthly    06-Dec-2022  
IMPNONDE                                Imports of Goods: Non-Manufactured Commodities for Delaware                                                                             NSA  Monthly    06-Dec-2022  
IMPNONFL                                Imports of Goods: Non-Manufactured Commodities for Florida                                                                              NSA  Monthly    06-Dec-2022  
IMPNONGA                                Imports of Goods: Non-Manufactured Commodities for Georgia                                                                              NSA  Monthly    06-Dec-2022  
IMPNONHI                                Imports of Goods: Non-Manufactured Commodities for Hawaii                                                                               NSA  Monthly    06-Dec-2022  
IMPNONIA                                Imports of Goods: Non-Manufactured Commodities for Iowa                                                                                 NSA  Monthly    06-Dec-2022  
IMPNONID                                Imports of Goods: Non-Manufactured Commodities for Idaho                                                                                NSA  Monthly    06-Dec-2022  
IMPNONIL                                Imports of Goods: Non-Manufactured Commodities for Illinois                                                                             NSA  Monthly    06-Dec-2022  
IMPNONIN                                Imports of Goods: Non-Manufactured Commodities for Indiana                                                                              NSA  Monthly    06-Dec-2022  
IMPNONKS                                Imports of Goods: Non-Manufactured Commodities for Kansas                                                                               NSA  Monthly    06-Dec-2022  
IMPNONKY                                Imports of Goods: Non-Manufactured Commodities for Kentucky                                                                             NSA  Monthly    06-Dec-2022  
IMPNONLA                                Imports of Goods: Non-Manufactured Commodities for Louisiana                                                                            NSA  Monthly    06-Dec-2022  
IMPNONMA                                Imports of Goods: Non-Manufactured Commodities for Massachusetts                                                                        NSA  Monthly    06-Dec-2022  
IMPNONMD                                Imports of Goods: Non-Manufactured Commodities for Maryland                                                                             NSA  Monthly    06-Dec-2022  
IMPNONME                                Imports of Goods: Non-Manufactured Commodities for Maine                                                                                NSA  Monthly    06-Dec-2022  
IMPNONMI                                Imports of Goods: Non-Manufactured Commodities for Michigan                                                                             NSA  Monthly    06-Dec-2022  
IMPNONMN                                Imports of Goods: Non-Manufactured Commodities for Minnesota                                                                            NSA  Monthly    06-Dec-2022  
IMPNONMO                                Imports of Goods: Non-Manufactured Commodities for Missouri                                                                             NSA  Monthly    06-Dec-2022  
IMPNONMS                                Imports of Goods: Non-Manufactured Commodities for Mississippi                                                                          NSA  Monthly    06-Dec-2022  
IMPNONMT                                Imports of Goods: Non-Manufactured Commodities for Montana                                                                              NSA  Monthly    06-Dec-2022  
IMPNONNC                                Imports of Goods: Non-Manufactured Commodities for North Carolina                                                                       NSA  Monthly    06-Dec-2022  
IMPNONND                                Imports of Goods: Non-Manufactured Commodities for North Dakota                                                                         NSA  Monthly    06-Dec-2022  
IMPNONNE                                Imports of Goods: Non-Manufactured Commodities for Nebraska                                                                             NSA  Monthly    06-Dec-2022  
IMPNONNH                                Imports of Goods: Non-Manufactured Commodities for New Hampshire                                                                        NSA  Monthly    06-Dec-2022  
IMPNONNJ                                Imports of Goods: Non-Manufactured Commodities for New Jersey                                                                           NSA  Monthly    06-Dec-2022  
IMPNONNM                                Imports of Goods: Non-Manufactured Commodities for New Mexico                                                                           NSA  Monthly    06-Dec-2022  
IMPNONNV                                Imports of Goods: Non-Manufactured Commodities for Nevada                                                                               NSA  Monthly    06-Dec-2022  
IMPNONNY                                Imports of Goods: Non-Manufactured Commodities for New York                                                                             NSA  Monthly    06-Dec-2022  
IMPNONOH                                Imports of Goods: Non-Manufactured Commodities for Ohio                                                                                 NSA  Monthly    06-Dec-2022  
IMPNONOK                                Imports of Goods: Non-Manufactured Commodities for Oklahoma                                                                             NSA  Monthly    06-Dec-2022  
IMPNONOR                                Imports of Goods: Non-Manufactured Commodities for Oregon                                                                               NSA  Monthly    06-Dec-2022  
IMPNONPA                                Imports of Goods: Non-Manufactured Commodities for Pennsylvania                                                                         NSA  Monthly    06-Dec-2022  
IMPNONPR                                Imports of Goods: Non-Manufactured Commodities for Puerto Rico                                                                          NSA  Monthly    06-Dec-2022  
IMPNONRI                                Imports of Goods: Non-Manufactured Commodities for Rhode Island                                                                         NSA  Monthly    06-Dec-2022  
IMPNONSC                                Imports of Goods: Non-Manufactured Commodities for South Carolina                                                                       NSA  Monthly    06-Dec-2022  
IMPNONSD                                Imports of Goods: Non-Manufactured Commodities for South Dakota                                                                         NSA  Monthly    06-Dec-2022  
IMPNONTN                                Imports of Goods: Non-Manufactured Commodities for Tennessee                                                                            NSA  Monthly    06-Dec-2022  
IMPNONTX                                Imports of Goods: Non-Manufactured Commodities for Texas                                                                                NSA  Monthly    06-Dec-2022  
IMPNONUS                                Imports of Goods: Non-Manufactured Commodities for United States                                                                        NSA  Monthly    06-Dec-2022  
IMPNONUT                                Imports of Goods: Non-Manufactured Commodities for Utah                                                                                 NSA  Monthly    06-Dec-2022  
IMPNONVA                                Imports of Goods: Non-Manufactured Commodities for Virginia                                                                             NSA  Monthly    06-Dec-2022  
IMPNONVI                                Imports of Goods: Non-Manufactured Commodities for U.S. Virgin Islands                                                                  NSA  Monthly    06-Dec-2022  
IMPNONVT                                Imports of Goods: Non-Manufactured Commodities for Vermont                                                                              NSA  Monthly    06-Dec-2022  
IMPNONWA                                Imports of Goods: Non-Manufactured Commodities for Washington                                                                           NSA  Monthly    06-Dec-2022  
IMPNONWI                                Imports of Goods: Non-Manufactured Commodities for Wisconsin                                                                            NSA  Monthly    06-Dec-2022  
IMPNONWV                                Imports of Goods: Non-Manufactured Commodities for West Virginia                                                                        NSA  Monthly    06-Dec-2022  
IMPNONWY                                Imports of Goods: Non-Manufactured Commodities for Wyoming                                                                              NSA  Monthly    06-Dec-2022  
IMPTOTAK                                Imports of Goods for Alaska                                                                                                             NSA  Monthly    06-Dec-2022  
IMPTOTAL                                Imports of Goods for Alabama                                                                                                            NSA  Monthly    06-Dec-2022  
IMPTOTAR                                Imports of Goods for Arkansas                                                                                                           NSA  Monthly    06-Dec-2022  
IMPTOTAZ                                Imports of Goods for Arizona                                                                                                            NSA  Monthly    06-Dec-2022  
IMPTOTCA                                Imports of Goods for California                                                                                                         NSA  Monthly    06-Dec-2022  
IMPTOTCO                                Imports of Goods for Colorado                                                                                                           NSA  Monthly    06-Dec-2022  
IMPTOTCT                                Imports of Goods for Connecticut                                                                                                        NSA  Monthly    06-Dec-2022  
IMPTOTDC                                Imports of Goods for District of Columbia                                                                                               NSA  Monthly    06-Dec-2022  
IMPTOTDE                                Imports of Goods for Delaware                                                                                                           NSA  Monthly    06-Dec-2022  
IMPTOTFL                                Imports of Goods for Florida                                                                                                            NSA  Monthly    06-Dec-2022  
IMPTOTGA                                Imports of Goods for Georgia                                                                                                            NSA  Monthly    06-Dec-2022  
IMPTOTHI                                Imports of Goods for Hawaii                                                                                                             NSA  Monthly    06-Dec-2022  
IMPTOTIA                                Imports of Goods for Iowa                                                                                                               NSA  Monthly    06-Dec-2022  
IMPTOTID                                Imports of Goods for Idaho                                                                                                              NSA  Monthly    06-Dec-2022  
IMPTOTIL                                Imports of Goods for Illinois                                                                                                           NSA  Monthly    06-Dec-2022  
IMPTOTIN                                Imports of Goods for Indiana                                                                                                            NSA  Monthly    06-Dec-2022  
IMPTOTKS                                Imports of Goods for Kansas                                                                                                             NSA  Monthly    06-Dec-2022  
IMPTOTKY                                Imports of Goods for Kentucky                                                                                                           NSA  Monthly    06-Dec-2022  
IMPTOTLA                                Imports of Goods for Louisiana                                                                                                          NSA  Monthly    06-Dec-2022  
IMPTOTMA                                Imports of Goods for Massachusetts                                                                                                      NSA  Monthly    06-Dec-2022  
IMPTOTMD                                Imports of Goods for Maryland                                                                                                           NSA  Monthly    06-Dec-2022  
IMPTOTME                                Imports of Goods for Maine                                                                                                              NSA  Monthly    06-Dec-2022  
IMPTOTMI                                Imports of Goods for Michigan                                                                                                           NSA  Monthly    06-Dec-2022  
IMPTOTMN                                Imports of Goods for Minnesota                                                                                                          NSA  Monthly    06-Dec-2022  
IMPTOTMO                                Imports of Goods for Missouri                                                                                                           NSA  Monthly    06-Dec-2022  
IMPTOTMS                                Imports of Goods for Mississippi                                                                                                        NSA  Monthly    06-Dec-2022  
IMPTOTMT                                Imports of Goods for Montana                                                                                                            NSA  Monthly    06-Dec-2022  
IMPTOTNC                                Imports of Goods for North Carolina                                                                                                     NSA  Monthly    06-Dec-2022  
IMPTOTND                                Imports of Goods for North Dakota                                                                                                       NSA  Monthly    06-Dec-2022  
IMPTOTNE                                Imports of Goods for Nebraska                                                                                                           NSA  Monthly    06-Dec-2022  
IMPTOTNH                                Imports of Goods for New Hampshire                                                                                                      NSA  Monthly    06-Dec-2022  
IMPTOTNJ                                Imports of Goods for New Jersey                                                                                                         NSA  Monthly    06-Dec-2022  
IMPTOTNM                                Imports of Goods for New Mexico                                                                                                         NSA  Monthly    06-Dec-2022  
IMPTOTNV                                Imports of Goods for Nevada                                                                                                             NSA  Monthly    06-Dec-2022  
IMPTOTNY                                Imports of Goods for New York                                                                                                           NSA  Monthly    06-Dec-2022  
IMPTOTOH                                Imports of Goods for Ohio                                                                                                               NSA  Monthly    06-Dec-2022  
IMPTOTOK                                Imports of Goods for Oklahoma                                                                                                           NSA  Monthly    06-Dec-2022  
IMPTOTOR                                Imports of Goods for Oregon                                                                                                             NSA  Monthly    06-Dec-2022  
IMPTOTPA                                Imports of Goods for Pennsylvania                                                                                                       NSA  Monthly    06-Dec-2022  
IMPTOTPR                                Imports of Goods for Puerto Rico                                                                                                        NSA  Monthly    06-Dec-2022  
IMPTOTRI                                Imports of Goods for Rhode Island                                                                                                       NSA  Monthly    06-Dec-2022  
IMPTOTSC                                Imports of Goods for South Carolina                                                                                                     NSA  Monthly    06-Dec-2022  
IMPTOTSD                                Imports of Goods for South Dakota                                                                                                       NSA  Monthly    06-Dec-2022  
IMPTOTTN                                Imports of Goods for Tennessee                                                                                                          NSA  Monthly    06-Dec-2022  
IMPTOTTX                                Imports of Goods for Texas                                                                                                              NSA  Monthly    06-Dec-2022  
IMPTOTUS                                Imports of Goods for United States                                                                                                      NSA  Monthly    06-Dec-2022  
IMPTOTUT                                Imports of Goods for Utah                                                                                                               NSA  Monthly    06-Dec-2022  
IMPTOTVA                                Imports of Goods for Virginia                                                                                                           NSA  Monthly    06-Dec-2022  
IMPTOTVI                                Imports of Goods for U.S. Virgin Islands                                                                                                NSA  Monthly    06-Dec-2022  
IMPTOTVT                                Imports of Goods for Vermont                                                                                                            NSA  Monthly    06-Dec-2022  
IMPTOTWA                                Imports of Goods for Washington                                                                                                         NSA  Monthly    06-Dec-2022  
IMPTOTWI                                Imports of Goods for Wisconsin                                                                                                          NSA  Monthly    06-Dec-2022  
IMPTOTWV                                Imports of Goods for West Virginia                                                                                                      NSA  Monthly    06-Dec-2022  
IMPTOTWY                                Imports of Goods for Wyoming                                                                                                            NSA  Monthly    06-Dec-2022  
